TApplicationProperties=app
TBasicAction=act
TBasicChartToolset=cts
TBevel=bvl
TChartAxisTransformations=cat
TChartExtentLink=cxl
TChartLegendPanel=clp
TChartStyles=chs
TCommonDialog=dlg
TCustomActionList=als
TCustomBarChart=bch
TCustomButton=btn
TCustomCalendar=cal
TCustomChart=chr
TCustomChartSource=chs
TCustomCheckBox=chk
TCustomComboBox=cmb
TCustomControlBar=bar
TCustomCoolBar=cbr
TCustomEdit=edt
TCustomForm=frm
TCustomFrame=frm
TCustomGrid=grd
TCustomGroupBox=grp
TCustomHeaderControl=hdr
TCustomImage=img
TCustomImageList=ils
TCustomLabel=txt
TCustomLazComponentQueue=lcq
TCustomListBox=lst
TCustomListView=lvw
TCustomLvlGraphControl=lgc
TCustomMemo=mem
TCustomPage=tab
TCustomPairSplitter=spl
TCustomPanel=pnl
TCustomProgressBar=prg
TCustomPropertyStorage=prp
TCustomScrollBar=slb
TCustomSpeedButton=btn
TCustomSplitter=spl
TCustomStaticText=txt
TCustomSynEdit=sed
TCustomSynMacroRecorder=smr
TCustomTabControl=tbc
TCustomTimer=tmr
TCustomTrackBar=trb
TCustomTreeView=tvw
TCustomUpDown=udn
TDataModule=dmd
TDataSet=dts
TDatasource=dsr
TDBCustomNavigator=nav
TDBEdit=
TDividerBevel=dbv
TEventLog=log
THelpDatabase=hdb
THelpViewer=hvw
TIDEDialogLayoutStorage=dls
TLabeledEdit=lbe
TMemo=mem
TMenuItem=mni
TMenu=mnu
TNotebook=ntb
TPaintBox=pbx
TPairSplitterSide=pss
TPopupNotifier=ntf
TProcess=prc
TRadioButton=rdb
TScrollBox=box
TShape=shp
TSimpleIPC=ipc
TStatusBar=stb
TSynAutoComplete=sac
TSynBaseCompletion=scm
TSynCustomExporter=sex
TSynCustomHighlighter=syn
TSynPluginCustomSyncroEdit=sse
TToggleBox=tgb
TToolBar=tbr
TToolButton=tbn
TTrayIcon=ico
TXMLConfig=xml
